1111111111111111111
1000100000000000101
10000000C00100P0001
1000010C001000E0011
10000C0100000000001
1000000000000000001
1111111111111111111