111111111111
10000P000001
100100010001
100100000111
101110000011
100010000001
100000010001
100000000001
1000110001E1
11001C000011
100000C00001
1000C0001011
110000110011
110000000001
101000100101
100010000001
1001001000C1
100001001001
100100000001
1000100000C1
100001010101
101000001001
111111111111
